***=Menu-Inicial****
titulo=Talkin' it over
jugar=Play
opciones=Options
ayuda=Help
cerrar=Close Game
***=Opciones****
musica=Music
efectos=Efects
graficos=Graphic
pantalla=Full screen
idioma=Language
atras=Back
***=Ayuda****
comoJugar=How to play
descripcion1=Talkin 'it Over is a 2D action platform video game in which you can play with friends locally and fight each other.
descripcion2=At the beginning of the game you will appear in a random scenario where you must defeat each other.
descripcion3=Be careful where you step! In each scenario there will be ledges where you can fall, traps and altars where you can take up weapons to defeat your opponent.
descripcion4=Within the stage itself, altars will appear, which will offer you a certain weapon. The weapon that he offers you will depend on the altar in question.
controlTeclado=Keyboard controls
controlMando=Gamepad controls
acercade=About
pausar=Pause
tomarArma=Take weapon
disparar=Shoot
moverse=Move
saltar=Jump
apuntar=Aim
***=Selector-Personaje****
jugador1=Player 1
jugador2=Player 2
jugador3=Player 3
jugador4=Player 4
unirse=Press 'Space' or 'X' to enter
empezar=Ready.... Press 'Start' or 'Enter'
volviendo=Return in 
***=Partida****
pausa=Pause
continuar=Continue
salir=Exit
puntuacion1=Player 
puntuacion2= rounds won