***=Menu-Inicial****
titulo=Talkin' it over
jugar=Jugar
opciones=Opciones
ayuda=Ayuda
cerrar=Cerrar juego
***=Opciones****
musica=Música
efectos=Efectos
graficos=Gráficos
pantalla=Pantalla completa
idioma=Idioma
atras=Atras
***=Ayuda****
comoJugar=Como se juega
descripcion1=Talkin' it Over es un videojuego de acción 2D con plataformas en el que podréis jugar con amigos de manera local y luchar el uno contra el otro.
descripcion2=Al empezar la partida apareceréis en un escenario aleatorio donde deberéis derrotaros los unos a los otros.
descripcion3=¡Tened cuidado de donde pisáis!. En cada escenario habrá salientes donde os podréis caer, trampas y altares donde podréis tomar armas para vencer a vuestro oponente.
descripcion4=Dentro del propio escenario aparecerán unos altares, los cuales os ofrecerán una determinada arma. El arma que os ofrece dependerá del altar en cuestión.
controlTeclado=Controles del teclado
controlMando=Controles del mando
acercade=Acerca de
pausar=Pausar
tomarArma=Tomar arma
disparar=Disparar
moverse=Moverse
saltar=Saltar
apuntar=Apuntar
***=Selector-Personaje****
jugador1=Jugador 1
jugador2=Jugador 2
jugador3=Jugador 3
jugador4=Jugador 4
unirse=Pulsad 'Espacio' o 'X' para entrar
empezar=Listos.... Pulsad 'Start' o 'Enter'
volviendo=Volviendo en <data> de <data>
***=Partida****
pausa=Pausa
continuar=Continuar
salir=Salir
puntuacion1=Jugador
puntuacion2=Rondas ganadas